0011223344556677889910111213141516171819|
0011223344556677889910111213141516171819|
0011<>3344556677889910111213141516171819|
001122<>44556677889910111213141516171819|
00112233/\55<>77889910111213141516171819|
0011223344<>66/\889910111213141516171819|
001122334455<>/\/\9910111213141516171819|
0011223344/\/\<>88/\10111213141516171819|
00112233/\<>/\<><><>/\11/\13141516171819|
001122/\<><><><>/\/\10<>1213141516171819|
001122/\/\/\<>/\8899<>111213141516171819|
001122<>/\<><><>/\<>10111213141516171819|
00112233/\<><><><>/\10111213141516171819|
001122334455/\/\/\/\10111213141516171819|
0011223344556677889910111213141516171819|
0011223344556677889910111213141516171819|
0011223344556677889910111213141516171819|
0011223344556677889910111213141516171819|
0011223344556677889910111213141516171819|
0011223344556677889910111213141516171819|
